10 6 6 6 6 6 6 6 6 6 6 6 6 6 7 6 6 6 6 6 6 6 6 6 6 6 6 6 4
9 0 1 0 0 0 0 0 1 1 0 1 0 0 12 0 0 1 0 1 1 0 0 0 0 0 1 0 13
9 0 1 1 1 0 1 0 0 1 0 1 1 1 12 1 1 1 0 1 0 0 1 0 1 0 1 0 13
9 0 0 0 1 0 1 1 0 1 0 0 0 0 12 0 0 0 0 1 0 1 1 0 1 0 0 0 13
9 1 1 0 1 0 0 1 0 1 0 1 1 0 12 0 1 1 1 1 0 1 0 0 1 0 1 0 13
9 0 1 0 1 1 0 1 0 0 0 0 1 0 12 0 1 0 0 0 0 1 0 1 1 0 1 0 13
9 0 1 0 0 1 0 1 1 1 1 0 1 1 12 1 1 0 1 1 1 1 0 1 0 0 1 0 13
18 26 4 0 1 0 0 0 0 0 1 0 0 0 12 0 0 0 1 0 0 0 0 1 0 1 10 26 22
9 0 23 0 1 0 1 1 1 0 1 0 1 0 12 0 1 1 1 0 1 1 1 0 0 1 9 0 13
9 0 23 0 0 0 0 0 1 0 0 0 1 0 20 0 1 0 0 0 1 0 0 0 1 1 9 0 13
9 0 23 1 1 0 1 0 1 1 1 0 1 1 12 1 1 0 1 1 1 0 0 1 1 0 9 0 13
19 25 3 0 0 0 1 0 0 0 1 0 0 0 12 0 0 0 1 0 0 0 1 0 0 0 2 25 21
9 0 1 0 1 0 1 1 1 0 1 1 1 0 12 0 1 1 1 0 1 1 1 0 1 0 1 1 13
9 0 0 0 1 0 0 0 1 0 0 0 1 0 12 0 1 0 0 0 1 0 0 0 1 0 0 0 13
9 1 1 0 1 1 1 0 1 1 1 0 1 1 12 1 1 0 1 1 1 0 1 1 1 0 1 1 13
9 0 1 0 0 0 1 0 0 0 1 0 0 0 12 0 0 0 1 0 0 0 1 0 0 0 1 0 13
9 0 1 1 1 0 1 1 1 0 1 1 1 1 12 1 0 1 1 0 1 1 1 1 1 0 1 0 13
9 0 0 0 0 0 0 0 0 0 0 0 0 0 12 0 0 0 0 0 0 0 0 0 0 0 0 0 13
2 5 5 5 5 5 5 5 5 5 5 5 5 5 8 5 5 5 5 5 5 5 5 5 5 5 5 5 3